#########################
#              #        #
#  ####        #  ####  #
#  #  #           #  #  #
#  #  #####      #### # #
#        #          #   #
#####         ####  ##  #
#   #                   #
#   ###           ####  #
#     #           #  #  #
##### ###         #  #  #
#     #                 #
#  #  ##   ##   #####   #
#  #       #        #   #
#####      #  #    ######
#      #            #   #
#  #   ###     #######  #
#                       #
#########################
