#####################
##    #  #        ###
#    ###    #  # ## #
#     ## #  # ##    #
#  ##    ##     # # #
#    #           #  #
#       ####    #   #
#          #   #### #
#  #         #     ##
#    ###  #   #   # #
# #  # # #   #      #
# #    # #     # # ##
#      ##    #    # #
##     #           ##
#    ##    #    ## ##
#      # #        # #
#    #           ## #
# #      # #        #
#  #  #   #        ##
# ##  ##            #
#            #   #  #
###    #       ##   #
#                   #
#     #  ###   #   ##
##    #        # # ##
#      # # # ##     #
# #     ##      #  ##
#     #         ## ##
#   #   # # #       #
## #      #        ##
# # #     #   #     #
# # ## #  #    #### #
# #  #  ##  # ###   #
# ##                #
#  #    #   #  #    #
##        # ##      #
# #  ##  # ###    # #
#   #   ##  #      ##
### #    #  #    ## #
# #    # #   #  # # #
##         # # #    #
#      #  ###       #
#    # #     #     ##
# # #   #   #    ## #
# ## # ##   #   #   #
#####################
