#################################################
# #   # # #    # # #  #         ##       #### # #
#          #                     # #  #  # # #  #
##    #       #    #  #  #  #        #          #
##   # #   #         #   #    ##    #   #   # ###
#        #     ## ##  # ###      ##           # #
#     ###  # # #   #        #  ##  # ### ##    ##
#  #  #   # #     #  #      # # #  #  # #  #    #
#       #    # #                # ##   #  ##  # #
##                ## #     #    # #  #  #   #   #
# #                                ##     #     #
# # #   ## #        #    #  #  ## ## # ##   #   #
## # ##          # # #   # #          #   #     #
##     ##  # #            ##  #       ##    ## ##
##    #    ##  #          #     # #  #    # #   #
#   #    ##     # #      ##    ##  #    ###   # #
###   #  #  # ###  ###     # ## # #       ##  # #
##  #          #    #         ## ####      ### ##
##         #     #           #         ##     # #
# #   ####       ## # #       #   ###     #  # ##
##   ##    #   ##   #        #  # #      # #    #
###     #      #  # #            ##    #        #
##    # ### ##              ## #  ####  #   #  ##
#                # ##   #  # ####              ##
###   ##  ####     ##  # #####      ##        ###
##  #  ##  #  ### #  ##           #       # #   #
#  #   ## #   #  #   #    ##   #  #     ##   #  #
#  #   #    #             #        #      #    ##
## #     #       # #    ##       #   #     #  # #
#################################################
