######################
## #     # ##  # ##  #
#    ##  #           #
# ##    ##           #
# #    #             #
#   # #   # ## #     #
#         # ###    # #
#    #     # #       #
######################
